      # ####   
  #   # # # #  
 ##   #  ## ###
  # #### #   ##
## ## ##  # ###
      #  ##    
  #   # # # #  
 ##      ## ###
  # #### #   ##
### # ###   ###
      # # ##   
  #   # # # #  
 ##   #     ###
  # #### #    
##### ##### ## 