      # ####   
  #   # # # #  
 ##   #  ## ###
  # #### #   ##
## ## ## ## ###
      #  ###   
  #   # # # #  
 ##   #  ## ###
  # #### #   ##
##### ##### ###
      # ####   
  #   # # # #  
 ##   #     ###
  # #### #    
##### ##### ## 